Josue
1111111111
10000R0001
1000000001
1000000001
1000000001
1000000001
1000000001
1000000001
1000000001
1111111111
